1111111111111111111111111111111111
1E0000000000000C00000C000000000001
1010010100100000101001000010010101
11100100101010100010010000C1010011
1P000000C00C0000000000000100001C11
1111111111111111111111111111111111
