1111111111111
1CC10CCCC0CC1
11C0C11111CC1
1P0011E0CCCC1
1111111111111