NO        ./north
SO       ./south
WE      ./west
EA ./east
F 222,1,1
C      225,30,0


1111111111
1000100001
10N0111011
1000111011
1111111111
