NO            textures/redbrick.xpm
SO       textures/colorstone.xpm
WE      textures/greystone.xpm
EA   textures/wood.xpm

F           220,       99      , 100
C 102, 153, 255


        111111111111111111111111111
        100000000000000000000001111
  111   111000000000000000000000011
  101   10000000000000000000000011
111011111000000000001111111111111
100000000000000000000000000011
1000000000000001100000000000001
10000000N000100000000000000001
110000000000000000000000000001
100000011111000000000000000001
10000000000000000001010000011
11000001110101011111011110101
11110111 1110111 101111010001
11111111 1111111 111111111111

