111111111111111111111
1E0000000000000C00001
101001010010000010101
101001001010101000101
1P0000000C00C00000001
100000C00000000C00001
100001000001001111001
111111111111111111111