111111111111111111111
1E0000000000000C00001
101001010010000010101
101001001010101000101
1P0001110C00C00000001
100001C10000000C00001
100001110001001111001
111111111111111111111