1111111111111
1C01000000001
1100011111001
1P0011EC00001
1111111111111